NO ./sources/srcs_cub3d/texture/a.xpm
SO ./sources/srcs_cub3d/texture/b.xpm
WE ./sources/srcs_cub3d/texture/c.xpm 
EA ./sources/srcs_cub3d/texture/ad.xpm

F 64,64,64
C 20,01    , 255     



        1111111111111111111111111
        1000000000110000000000001
        1011000001110000000000001
        1001000000001000000000001
11111111101100000111 10000000000001
100000000011000001111111100011111
11110111111111011100000010001   
11110111111111011101010010001
11000000110101011100000010001
10000000000000000000000000001
10000000000000001101010010001
11000001110101011111011110N111
11110111 1110101 101111010001
11111111 1111111 111111111111



