NO ./texture/n.xpm 
SO ./texture/s.xpm
WE ./texture/w.xpm
EA ./texture/e.xpm

F 0,100,          51
C 51,151,255      

1111111111111111111111111
1000000000110000000W00001
1111111111111111111111111
