            SO ./texture/s.xpm
            WE ./texture/w.xpm
NO ./texture/n.xpm
F       150,50,255
 C 0,100,255     
EA ./texture/e.xpm




1111111111111111111111111
1111111111111111111111111
1000000000110000000000001
1000000000000000000000001
1000000000000000000000001                        
111000000000110000000W0001
1000000000110000000000001
1000000000000000000000001
1000000000000000000000001                        
11100000000011000000000001
1000000000000000000000001
1000000000000000000000001                        
11100000000011000000000001
1000000000000000000000001
1000000000000000000000001                        
11100000000011000000000001
1000000000000000000000001
1000000000000000000000001                        
11100000000011000000000001
1000000000000000000000001
1000000000000000000000001                        
11100000000011000000000001
1000000000000000000000001
1000000000000000000000001                        
11100000000011000000000001
1000000000000000000000001
1000000000000000000000001                        
11100000000011000000000001
1000000000000000000000001
1000000000000000000000001                        
11100000000011000000000001
1111111111111111111111111
1                         1





1

