NO ./texture/n.xpm 
SO ./texture/s.xpm
WE ./texture/w.xpm
EA ./texture/e.xpm

F 0,100,          51
C 51,151,255      

1111111111111111111111111
1000000000110000000000001
1011000001110000000000001
100100000000000000000000111111111
111111111011000001110000000000001
100000000011000001110111111111111  
111101111111111111000000100011111
    11110111    11011101010010001
    11000000110101011100000010001
    10000000000000001100000000001
    10000000000000001101010010001
    11000001110101011111011110N0111
    1111011101110101101111010001
    1111111 11111111111111111111
