C 15, 15,125

F  100,150,


NO ./texture/n.xpm
    EA ./texture/e.xpm
SO ./texture/s.xpm
WE ./texture/w.xpm






       11111111111111111111111111111  111111111111                                                                              11111111111111111111111111111
        1000000000110000000000001101  110011
        101100000111000000000000111   10001
        100100000000000000000000111   111111
111111111011000001110000000000001
1100000000011000001110111111111111
1111011111111101110000010001
11110000111111011101010010001                                             1
11000000010101111110000001000111                                    1111111
10000000000001 10001100000010001                                     11101
100E00000000011110011010100100011                                     11101111
11000000001011111111110000111111                                    111  11111
1111011001110101 10111101000111
1111111111111111 111111111111
1111111
1010001
1111111
1111111111111111111111111


1



