            SO ./texture/s.xpm
                 WE ./texture/w.xpm

NO ./texture/n.xpm
F       150,50,255
C 0,100,255     
EA ./texture/e.xpm





111111
1111111111111111111111111
1000000000110000000W00001
1111111111111111111111111
