NO ./texture/n.xpm
EA ./texture/e.xpm
SO ./texture/s.xpm
WE ./texture/w.xpm

F  100,150,100
C 100,100,255


        1111111111111111111111111
        1000000000110000000000001
        1011000001110000000000001
        1001000000000000000000001
111111111011000001110000000000001
100000000011000001110000000111111
111101111111110111000000001111111111111111111111111111111111111111111111111111111111111111
111101111111110111010100000000000000000000000000000000000000000000000000000000000000000001
110000001101010111000000000000000000000000000000000000000000000000000000000000000000000001
10000000000000001100000000000000000000N000000000000000000000000000000000000000000000000001
100000000000000011010100100000000000000000000000000000000000000000000000000000000000000001
1100000111010101111100000000000000000000000000000000000000000000000000000000000000000000111
11110111 1110101 1010000000000000000000001111111111111111111111111111111111111111111111111111111
11110111 1110101 1010000000000000000000001111111111111111111111111111111111111111111111111111111
11110111 1110101 1010000000000000000000001111111111111111111111111111111111111111111111111111111
11110111 1110101 1010000000000000000000001111111111111111111111111111111111111111111111111111111
11110111 1110101 1010000000000000000000001111111111111111111111111111111111111111111111111111111
11110111 1110101 1010000000000000000000001111111111111111111111111111111111111111111111111111111
11110111 1110101 1010000000000000000000001111111111111111111111111111111111111111111111111111111
11110111 1110101 1010000000000000000000001111111111111111111111111111111111111111111111111111111
11110111 1110101 1010000000000000000000001111111111111111111111111111111111111111111111111111111
11110111 1110101 1010000000000000000000001111111111111111111111111111111111111111111111111111111
11111111 1111111 11111111111111111111111111
