

NO ./texture/n.xpm
EA ./texture/e.xpm
SO ./texture/s.xpm
WE               ./texture/w.xpm                              
F  100,150,100
C 100,100,255

111111111
10E000001
100001001
1111111111
111111
   
   1111111